1111111111111111111111111111111111111
1111111100000000000000011111110000001
11111000000000000C0000000000000000001
1000000000C000000011100000001000C0001
100C00000C00000111100C000011110000001
1000100000000000110000000010000000001
100111000P0000100000000C000000E000011
101111100C000010000000000000000001111
1111111111111111111111111111111111111
