1111111111111111111111111111111111111111111111111
11111111000000000000000111111100000000000000C0001
11111000000000000C00000000000000000C0000011111111
1000000000C00000000000000000100000000000000011111
100C00000C00000000C0000000111100000C0000000000111
1000100000000000000000000010000000000111000000111
100111000P0000100000000C0000000000000011000011111
101111100C000010000000000000000001100000C00000001
1000110000000111000000C000000001111000000000E0001
10000C0000011111100000000000111111100000000000111
1000000000000000000C00000000111000000000000011111
1000000000C00000000000000001110000000000000011111
1111111111111111111111111111111111111111111111111
